51 51
0400 0400 0400 0400 0400 0400 0400 0400 0400 0400 0400 0100 0100 0100 0100 0100 0100 0400 0400 0400 0400 0400 0400 0400 0400 0400 0400 0400 0400 0400 0400 0400 0400 0400 0400 0400 0400 0400 0400 0400 0400 0400 0400 0400 0400 0400 0400 0400 0400 0400 0400
0400 0400 0400 0400 0400 0400 0400 0400 0400 0100 0100 0100 0100 0100 0100 0100 0100 0400 0400 0400 0400 0400 0400 0400 0400 0400 0400 0400 0400 0400 0400 0400 0400 0400 0400 0400 0400 0400 0400 0400 0400 0400 0400 0400 0400 0400 0400 0400 0400 0400 0400
0400 0400 0400 0600 0400 0400 0400 0400 0400 0100 0100 0100 0100 0100 0100 0100 0400 0400 0400 0400 0400 0400 0400 0400 0400 0400 0400 0400 0400 0400 0400 0400 0400 0400 0400 0400 0400 0400 0400 0400 0400 0400 0400 0400 0400 0400 0400 0400 0400 0400 0400
0400 0400 0600 0600 0400 0400 0400 0400 0400 0100 0100 0100 0100 0095 0100 0400 0400 0400 0400 0400 0400 0400 0400 0400 0400 0400 0400 0400 0400 0400 0400 0400 0400 0400 0750 0750 0750 0400 0400 0400 0400 0400 0400 0400 0400 0400 0400 0400 0400 0400 0400
0400 0600 0600 0600 0600 0400 0400 0400 0400 0100 0100 0100 0100 0100 0400 0400 0400 0400 0400 0400 0400 0400 0400 0400 0400 0400 0400 0400 0400 0400 0400 0400 0400 0750 1100 1100 0750 0400 0400 0400 0400 0400 0400 0400 0400 0400 0400 0400 0400 0400 0400
0400 0600 0600 0600 0400 0400 0400 0400 0400 0400 0400 0100 0400 0400 0400 0400 0400 0400 0400 0400 0400 0400 0400 0400 0400 0400 0400 0400 0400 0400 0400 0400 0750 1100 1100 1100 0750 0400 0400 0400 0400 0400 0400 0100 0100 0400 0400 0400 0400 0400 0400
0400 0400 0600 0400 0400 0400 0400 0400 0400 0400 0400 0400 0400 0400 0400 0400 0400 0400 0400 0400 0400 0400 0400 0400 0400 0400 0400 0400 0400 0400 0400 0750 1100 1100 1100 0750 0400 0400 0400 0400 0400 0400 0400 0400 0100 0100 0400 0400 0400 0400 0400
0400 0400 0400 0400 0400 0400 0400 0400 0400 0400 0400 0400 0400 0400 0400 0400 0400 0400 0400 0400 0400 0400 0400 0400 0400 0400 0400 0400 0400 0400 0750 1100 1100 1100 1100 0750 0400 0400 0400 0400 0400 0400 0400 0400 0400 0100 0100 0100 0400 0400 0400
0400 0400 0400 0400 0400 0400 0400 0400 0600 0600 0600 0600 0600 0400 0400 0400 0400 0400 0400 0400 0400 0400 0400 0400 0400 0400 0400 0400 0400 0750 1100 1100 1100 0750 0750 0400 0400 0400 0400 0400 0400 0400 0400 0400 0400 0100 0100 0100 0400 0400 0400
0400 0400 0400 0400 0400 0400 0400 0600 0600 0750 0600 0600 0400 0400 0400 0400 0400 0400 0400 0400 0400 0400 0400 0400 0400 0400 0600 0600 0750 0750 1100 1100 1100 0750 0400 0400 0400 0400 0400 0400 0400 0400 0400 0400 0100 0100 0100 0100 0100 0400 0400
0400 0400 0400 0400 0400 0400 0600 0600 0600 0600 0600 0600 0400 0400 0400 0400 0400 0400 0400 0400 0400 0400 0400 0400 0400 0400 0600 0400 0750 1100 1100 1400 1100 0750 0400 0400 0400 0400 0400 0400 0400 0400 0400 0100 0100 0100 0050 0100 0100 0400 0400
0400 0400 0400 0400 0400 0600 0600 0600 0600 0600 0600 0600 0600 0400 0400 0400 0400 0400 0400 0400 0400 0400 0400 0400 0400 0400 0600 0600 0750 1100 1400 1100 0750 0400 0400 0400 0400 0400 0400 0400 0400 0400 0400 0400 0400 0400 0400 0400 0100 0100 0400
0400 0400 0400 0400 0400 0400 0400 0400 0600 0600 0600 0600 0600 0400 0400 0400 0400 0400 0400 0400 0400 0400 0600 0600 0600 0750 0600 1100 1100 1400 1400 1100 0750 0400 0400 0400 0400 0400 0400 0400 0400 0400 0400 0400 0400 0400 0400 0400 0100 0400 0400
0400 0400 0400 0400 0400 0400 0400 0400 0600 0600 0600 0600 0600 0400 0400 0400 0400 0400 0400 0400 0600 0600 0600 0600 0750 1100 0750 1100 1400 1400 1400 1100 0750 0400 0400 0400 0400 0400 0400 0400 0400 0400 0400 0400 0400 0400 0400 0400 0400 0400 0400
0400 0400 0400 0400 0400 0600 0600 0600 0600 0600 0600 0600 0600 0600 0400 0400 0400 0400 0600 0600 0600 0600 0750 0750 1100 1100 1100 1400 1400 1400 1100 0750 0400 0400 0400 0400 0400 0400 0400 0400 0400 0400 0400 0400 0400 0400 0400 0400 0400 0400 0400
0400 0400 0400 0400 0400 0600 0750 0600 0600 0600 0750 0750 0750 0600 0400 0600 0600 0400 0600 0600 0600 0750 1100 1100 1100 1400 1400 2000 1400 1400 1100 0750 0400 0400 0400 0400 0400 0400 0400 0400 0400 0400 0400 0400 0400 0400 0400 0400 0400 0400 0400
0400 0400 0400 0400 0400 0600 0750 0750 0750 0750 1100 1100 1100 0750 0600 0600 0600 0600 0600 0600 0750 1100 1400 1400 1800 2000 2000 2000 1400 1400 0750 0750 0400 0400 0400 0400 0400 0400 0400 0400 0400 0400 0400 0400 0400 0400 0400 0400 0400 0400 0400
0400 0400 0400 0400 0400 0600 0750 0750 0750 1100 1100 1100 1100 1100 0750 0600 0600 0600 0600 0750 1100 1400 1400 1800 2000 2000 2500 2000 1400 1100 1100 0400 0400 0400 0400 0400 0400 0400 0400 0400 0400 0400 0400 0400 0400 0400 0400 0400 0400 0400 0400
0400 0400 0400 0400 0400 0600 0600 0750 1100 1100 1100 1100 1100 1100 1100 0750 0600 0600 0750 1100 1400 1400 1800 2000 2500 2500 2500 2000 1400 0750 0600 0400 0400 0400 0400 0400 0400 0400 0400 0400 0400 0400 0400 0400 0400 0400 0400 0400 0400 0400 0400
0400 0400 0400 0400 0600 0600 0750 0750 1100 1100 1100 1100 1100 1100 1100 0750 0750 0750 0750 1100 1400 1400 2000 2500 2500 2500 2000 1400 1100 0750 0600 0400 0400 0400 0400 0400 0400 0400 0400 0400 0400 0400 0400 0400 0400 0400 0400 0400 0400 0400 0400
0400 0400 0400 0600 0600 0600 0750 1100 1100 1100 1100 1100 1100 1100 1100 0900 0750 0750 0750 1100 1400 1400 1800 2000 2500 2000 1800 1400 1100 0750 0600 0400 0400 0400 0400 0400 0400 0400 0400 0400 0400 0400 0400 0400 0400 0400 0400 0400 0400 0400 0400
0400 0400 0400 0600 0600 0600 0750 1100 1100 1100 1100 1100 1100 1100 1100 1100 0900 0750 0750 1100 1400 1400 1800 1800 2000 1800 1400 1100 0750 0600 0600 0400 0400 0400 0400 0400 0400 0400 0400 0400 0400 0400 0400 0400 0400 0400 0400 0400 0400 0400 0400
0400 0400 0400 0600 0600 0750 1100 1100 1100 1100 1100 1100 1100 1100 1100 1100 1100 0900 0750 1200 1200 1400 1400 1400 1800 1400 1100 0750 0600 0050 0400 0400 0400 0400 0400 0400 0400 0400 0400 0400 0400 0400 0400 0400 0400 0400 0400 0400 0400 0400 0400
0400 0400 0400 0600 0600 0750 1100 1100 1100 1300 1300 1200 1200 1200 1100 1100 1100 0900 0750 1100 1200 1400 1400 1400 1400 1100 0750 0600 0600 0400 0400 0400 0400 0400 0400 0400 0400 0400 0400 0400 0400 0400 0400 0400 0400 0400 0400 0400 0400 0400 0400
0400 0400 0400 0600 0600 0750 1100 1100 1100 1200 1400 1400 1400 1300 1200 1100 1100 0900 0750 1100 1200 1200 1200 1200 1100 0750 0750 0600 0600 0400 0400 0400 0400 0400 0400 0400 0400 0400 0400 0400 0400 0400 0400 0400 0400 0400 0400 0400 0400 0400 0400
0400 0400 0400 0400 0600 0600 0750 1100 1100 1200 1400 1800 1400 1300 1200 1100 1100 0900 0900 0750 1100 1200 1200 1100 0900 0750 0600 0600 0400 0400 0400 0400 0090 0100 0400 0400 0400 0400 0400 0400 0400 0400 0400 0400 0400 0400 0400 0400 0400 0400 0400
0400 0400 0400 0400 0400 0600 0600 0750 1100 1200 1400 1400 1400 1300 1200 1100 1100 0900 0900 0750 0900 1100 1100 0900 0900 0750 0600 0600 0400 0400 0400 0100 0100 0100 0100 0400 0400 0400 0400 0400 0400 0400 0400 0400 0400 0400 0400 0400 0400 0400 0400
0400 0400 0400 0400 0400 0600 0600 0750 0600 1100 1200 1200 1300 1300 1100 1100 0900 0750 0750 0750 0750 0750 0750 0750 0900 0900 0600 0400 0400 0400 0400 0400 0100 0100 0100 0400 0400 0400 0400 0400 0400 0400 0400 0400 0400 0400 0400 0400 0400 0400 0400
0400 0400 0400 0400 0400 0400 0600 0600 0600 1100 1100 1300 1300 1100 1100 0750 0750 0600 0600 0600 0600 0600 0600 0750 0900 0900 0750 0600 0400 0400 0400 0400 0400 0100 0100 0100 0400 0400 0400 0400 0400 0400 0400 0400 0400 0400 0400 0400 0400 0400 0400
0400 0400 0400 0400 0400 0400 0400 0600 0600 0600 1100 1100 1100 1100 0600 0600 0600 0600 0600 0600 0600 0600 0600 0750 0750 0750 0750 0400 0400 0400 0400 0400 0400 0400 0400 0400 0400 0400 0400 0400 0400 0400 0400 0400 0400 0400 0400 0400 0400 0400 0400
0400 0400 0400 0400 0400 0400 0400 0400 0400 0600 0600 1100 1100 0600 0600 0400 0600 0400 0400 0600 0400 0400 0600 0600 0750 0750 0750 0600 0400 0400 0400 0400 0400 0400 0400 0400 0400 0400 0400 0400 0400 0400 0400 0400 0400 0400 0400 0400 0400 0400 0400
0400 0400 0400 0400 0400 0400 0400 0400 0400 0400 0600 0600 0600 0600 0400 0400 0400 0400 0400 0400 0400 0400 0600 0600 0750 0750 0750 0600 0600 0400 0400 0400 0400 0400 0400 0400 0400 0400 0400 0400 0400 0400 0400 0400 0400 0400 0400 0400 0400 0400 0400
0400 0400 0400 0400 0400 0400 0400 0400 0400 0400 0400 0400 0400 0400 0400 0400 0400 0400 0400 0400 0400 0400 0600 0600 0750 0750 0750 0600 0400 0400 0400 0400 0400 0400 0400 0400 0400 0400 0400 0400 0400 0400 0400 0400 0400 0400 0400 0400 0400 0400 0400
0400 0400 0400 0400 0400 0400 0400 0400 0400 0400 0400 0400 0400 0400 0400 0400 0400 0400 0400 0400 0400 0400 0600 0600 0750 0750 0600 0400 0400 0400 0400 0400 0400 0400 0400 0400 0400 0400 0400 0400 0400 0600 0600 0600 0600 0400 0400 0400 0400 0400 0400
0400 0400 0400 0400 0400 0400 0400 0400 0400 0400 0400 0400 0400 0400 0400 0400 0400 0400 0400 0400 0400 0400 0600 0600 0600 0900 0600 0400 0400 0400 0400 0400 0400 0400 0400 0400 0400 0400 0400 0400 0600 0600 0600 0600 0600 0600 0400 0400 0400 0400 0400
0400 0400 0400 0400 0400 0400 0400 0400 0400 0400 0400 0400 0400 0400 0400 0400 0400 0400 0400 0400 0400 0400 0400 0600 0600 0900 0600 0400 0400 0400 0400 0400 0400 0400 0400 0400 0400 0400 0400 0600 0600 0750 0750 0750 0750 0600 0600 0400 0400 0400 0400
0400 0400 0400 0400 0400 0400 0400 0400 0400 0400 0400 0400 0400 0400 0400 0400 0400 0400 0400 0400 0400 0400 0400 0600 0600 0900 0600 0400 0400 0400 0400 0400 0400 0400 0400 0400 0400 0400 0600 0600 0750 2000 1800 1800 0750 0750 0600 0600 0400 0400 0400
0400 0400 0400 0400 0400 0400 0400 0400 0400 0400 0400 0400 0400 0400 0400 0400 0400 0400 0400 0400 0400 0400 0400 0600 0600 0750 0600 0400 0400 0400 0400 0400 0400 0400 0400 0400 0400 0600 0600 0750 1800 2500 1800 0750 0600 0600 0600 0600 0600 0400 0400
0400 0400 0400 0400 0400 0400 0400 0400 0400 0400 0400 0400 0400 0400 0400 0400 0400 0400 0400 0400 0400 0400 0400 0600 0750 0600 0600 0400 0400 0400 0400 0400 0400 0400 0400 0400 0600 0600 0750 1800 1800 2000 0750 0600 0600 0400 0400 0400 0400 0400 0400
0400 0400 0400 0400 0400 0400 0400 0400 0400 0400 0100 0100 0100 0400 0400 0400 0400 0400 0400 0400 0400 0600 0400 0600 0750 0750 0750 0400 0400 0400 0400 0400 0400 0400 0400 0600 0600 0750 1100 1100 1100 0750 0600 0600 0400 0400 0400 0400 0400 0400 0400
0400 0400 0400 0400 0400 0400 0400 0400 0400 0400 0100 0100 0100 0100 0400 0400 0400 0400 0400 0400 0600 0600 0600 0750 0900 0750 0600 0400 0400 0400 0400 0400 0400 0400 0400 0600 0750 1800 1800 1800 0750 0600 0600 0400 0400 0400 0400 0400 0400 0400 0400
0400 0400 0400 0400 0400 0400 0400 0400 0400 0100 0090 0100 0100 0100 0100 0400 0400 0400 0400 0400 0600 0600 0750 0900 1100 0750 0400 0400 0400 0400 0400 0400 0400 0400 0600 0600 1800 2500 2000 1800 0600 0600 0100 0100 0400 0400 0400 0400 0400 0400 0400
0400 0400 0400 0400 0400 0400 0400 0400 0400 0100 0100 0100 0100 0100 0100 0400 0400 0400 0400 0400 0400 0600 0750 0750 0750 0600 0400 0400 0400 0400 0400 0400 0400 0600 0600 0750 1800 1800 2000 0600 0600 0400 0100 0100 0100 0400 0400 0400 0400 0400 0400
0400 0400 0400 0400 0400 0400 0400 0100 0100 0100 0100 0100 0100 0100 0100 0400 0400 0400 0400 0400 0400 0400 0600 0600 0600 0600 0400 0400 0400 0400 0400 0400 0400 0600 0600 0750 1800 0750 0600 0600 0400 0400 0400 0100 0100 0100 0400 0400 0400 0400 0400
0400 0400 0400 0400 0400 0400 0100 0100 0100 0100 0100 0100 0100 0100 0100 0100 0400 0400 0400 0400 0400 0400 0600 0600 0600 0400 0400 0400 0400 0400 0400 0400 0400 0400 0600 0600 0750 0600 0600 0400 0400 0400 0400 0100 0100 0100 0100 0400 0400 0400 0400
0400 0400 0400 0400 0400 0100 0100 0100 0100 0100 0100 0100 0100 0100 0100 0100 0400 0400 0400 0400 0400 0400 0400 0600 0600 0400 0400 0400 0400 0400 0400 0400 0400 0400 0600 0600 0600 0600 0400 0400 0400 0400 0400 0400 0100 0020 0400 0400 0400 0400 0400
0400 0400 0400 0400 0400 0400 0100 0100 0100 0100 0100 0100 0100 0100 0100 0100 0400 0400 0400 0400 0400 0400 0400 0600 0400 0400 0400 0400 0400 0400 0400 0400 0400 0400 0400 0600 0600 0600 0400 0400 0400 0400 0400 0400 0100 0100 0100 0400 0400 0400 0400
0400 0400 0400 0400 0400 0400 0100 0100 0100 0100 0100 0100 0100 0100 0100 0100 0400 0400 0400 0400 0400 0400 0400 0400 0400 0400 0400 0400 0400 0400 0400 0400 0400 0400 0400 0400 0600 0600 0400 0400 0400 0400 0400 0400 0400 0100 0100 0400 0400 0400 0400
0400 0400 0400 0400 0400 0400 0400 0100 0100 0100 0100 0100 0100 0100 0100 0400 0400 0400 0400 0400 0400 0400 0400 0400 0400 0400 0400 0400 0400 0400 0400 0400 0400 0400 0400 0400 0400 0400 0400 0400 0400 0400 0400 0400 0400 0400 0400 0400 0400 0400 0400
0400 0400 0400 0400 0400 0400 0400 0100 0100 0100 0100 0100 0100 0100 0400 0400 0400 0400 0400 0400 0400 0400 0400 0400 0400 0400 0400 0400 0400 0400 0400 0400 0400 0400 0400 0400 0400 0400 0400 0400 0400 0400 0400 0400 0400 0400 0400 0400 0400 0400 0400
0400 0400 0400 0400 0400 0400 0400 0400 0100 0400 0400 0400 0100 0400 0400 0400 0400 0400 0400 0400 0400 0400 0400 0400 0400 0400 0400 0400 0400 0400 0400 0400 0400 0400 0400 0400 0400 0400 0400 0400 0400 0400 0400 0400 0400 0400 0400 0400 0400 0400 0400